#######
#     #
# #$@ #
# * *##
##.* ##
# $ .##
#    ##
#######